 #########
 #       #
##     A #
=D  31  B#
=E  42   #
##     C #
 #       #
 #########