 #=#
## #
# A##
##1B#
#C2##
##3D#
#E4##
##F #
 # ##
 # #