#######
#     =
#     =
#   ###
#   #
#   #
# 1 ###
# A2
# 34
#
#######