####@####
###   ###
##     ##
#       #
@  12   @
#   3   #
##  4/ ##
###   ###
####@####
