   #@#   
  # A #  
 #     # 
#       #
@B 12  D@
#   3   #
 #  4/ # 
  # C #  
   #@#   