#===#
#   #
# A #
# 1B#
#234#
# CD#
#   #