  #######
 ##     #
##     ##
#  A3 ##
# 412 #
#    ##
#   ##
#  ##
#####