 #########
 #       #
##       #
=   31A  #
=  42B   #
##       #
 #       #
 #########