########
=      =
#   1A #
#  ##2 #
#  43  #
#      #
###  ###