#######
#     #
#   A #
#     #
#######