#####=#######
#    3     C#
#### ########
=4        2 =
#%1%######  #
#% %#%% B#  #
#D       # A#
#############
